20
20
0 0 0 0 0 0 0 0 0 0 0 0 0 0 0 0 0 0 0 0 
0 0 0 0 0 0 0 0 0 0 0 0 0 0 0 0 0 0 0 0 
0 0 0 0 0 0 0 0 0 0 0 0 0 0 0 0 0 0 0 0 
0 0 0 0 0 0 0 0 0 0 0 0 0 0 0 0 0 0 0 0 
0 0 0 0 0 0 0 0 0 0 0 0 0 16 17 18 0 0 0 0 
0 0 16 17 18 0 0 0 0 0 0 0 0 12 13 14 0 0 0 0 
0 0 12 13 14 0 0 0 0 0 0 0 0 8 9 10 0 0 0 0 
0 0 8 9 10 0 0 0 16 17 18 0 0 4 5 6 0 0 0 0 
0 0 4 5 6 0 0 0 12 13 14 0 0 0 0 0 0 0 0 0 
0 0 0 0 0 0 0 0 8 9 10 0 0 0 0 0 0 0 0 0 
0 0 0 0 0 0 0 0 4 5 6 0 0 0 0 0 0 0 0 0 
0 0 0 0 0 0 0 0 0 0 0 0 0 0 0 0 0 0 0 0 
0 0 0 0 0 0 16 17 18 0 0 0 0 0 0 0 0 0 0 0 
0 0 0 0 0 0 12 13 14 0 0 0 0 0 16 17 18 0 0 0 
0 0 0 0 0 0 8 9 10 0 0 0 0 0 12 13 14 0 0 0 
0 0 0 0 0 0 4 5 6 0 0 0 0 0 8 9 10 0 0 0 
0 0 0 0 0 0 0 0 0 0 0 0 0 0 4 5 6 0 0 0 
0 0 0 0 0 0 0 0 0 0 0 0 0 0 0 0 0 0 0 0 
0 0 0 0 0 0 0 0 0 0 0 0 0 0 0 0 0 0 0 0 
0 0 0 0 0 0 0 0 0 0 0 0 0 0 0 0 0 0 0 0 
