20
20
The
None
1
1 1 1 1 1 1 1 1 1 1 1 1 1 1 1 1 1 1 1 1 
1 1 1 1 1 1 1 1 1 1 1 1 1 1 1 1 1 1 1 1 
1 1 1 1 1 1 1 1 1 1 1 1 1 1 1 1 1 1 1 1 
1 1 1 48 49 50 51 1 48 49 50 51 1 48 49 50 51 1 1 1 
1 1 1 44 45 46 47 1 44 45 46 47 1 44 45 46 47 1 1 1 
1 1 1 40 41 42 43 1 40 41 42 43 1 40 41 42 43 1 1 1 
1 1 1 36 37 38 39 1 36 37 38 39 1 36 37 38 39 1 1 1 
1 1 1 1 1 1 1 1 1 1 1 1 1 1 1 1 1 1 1 1 
1 1 1 48 49 50 51 1 48 49 50 51 1 48 49 50 51 1 1 1 
1 1 1 44 45 46 47 1 44 45 46 47 1 44 45 46 47 1 1 1 
1 1 1 40 41 42 43 1 40 41 42 43 1 40 41 42 43 1 1 1 
1 1 1 36 37 38 39 1 36 37 38 39 1 36 37 38 39 1 1 1 
1 1 1 1 1 1 1 1 1 1 1 1 1 1 1 1 1 1 1 1 
1 1 1 48 49 50 51 1 48 49 50 51 1 48 49 50 51 1 1 1 
1 1 1 44 45 46 47 1 44 45 46 47 1 44 45 46 47 1 1 1 
1 1 1 40 41 42 43 1 40 41 42 43 1 40 41 42 43 1 1 1 
1 1 1 36 37 38 39 1 36 37 38 39 1 36 37 38 39 1 1 1 
1 1 1 1 1 1 1 1 1 1 1 1 1 1 1 1 1 1 1 1 
1 1 1 1 1 1 1 1 1 1 1 1 1 1 1 1 1 1 1 1 
1 1 1 1 1 1 1 1 1 1 1 1 1 1 1 1 1 1 1 1 
0 0 0 0 0 0 0 0 0 0 0 0 0 0 0 0 0 0 0 0 
0 0 0 0 0 0 0 0 0 0 0 0 0 0 0 0 0 0 0 0 
0 0 0 0 0 0 0 0 0 0 0 0 0 0 0 0 0 0 0 0 
0 0 0 1 1 1 1 0 1 1 1 1 0 1 1 1 1 0 0 0 
0 0 0 1 1 1 1 0 1 1 1 1 0 1 1 1 1 0 0 0 
0 0 0 1 1 1 1 0 1 1 1 1 0 1 1 1 1 0 0 0 
0 0 0 0 0 0 0 0 0 0 0 0 0 0 0 0 0 0 0 0 
0 0 0 0 0 0 0 0 0 0 0 0 0 0 0 0 0 0 0 0 
0 0 0 1 1 1 1 0 1 1 1 1 0 1 1 1 1 0 0 0 
0 0 0 1 1 1 1 0 1 1 1 1 0 1 1 1 1 0 0 0 
0 0 0 1 1 1 1 0 1 1 1 1 0 1 1 1 1 0 0 0 
0 0 0 0 0 0 0 0 0 0 0 0 0 0 0 0 0 0 0 0 
0 0 0 0 0 0 0 0 0 0 0 0 0 0 0 0 0 0 0 0 
0 0 0 1 1 1 1 0 1 1 1 1 0 1 1 1 1 0 0 0 
0 0 0 1 1 1 1 0 1 1 1 1 0 1 1 1 1 0 0 0 
0 0 0 1 1 1 1 0 1 1 1 1 0 1 1 1 1 0 0 0 
0 0 0 0 0 0 0 0 0 0 0 0 0 0 0 0 0 0 0 0 
0 0 0 0 0 0 0 0 0 0 0 0 0 0 0 0 0 0 0 0 
0 0 0 0 0 0 0 0 0 0 0 0 0 0 0 0 0 0 0 0 
0 0 0 0 0 0 0 0 0 0 0 0 0 0 0 0 0 0 0 0 
connect Bigger_Town left -32 -23
connect justin left -35 9
