20
20
1 1 1 1 1 1 1 1 1 1 1 1 1 1 1 1 1 1 1 1 
1 1 1 1 1 1 1 1 1 1 1 1 1 1 1 1 1 1 1 1 
1 1 1 1 1 1 1 1 1 1 1 1 1 1 1 48 49 50 51 1 
1 1 1 1 1 1 1 48 49 50 51 1 1 1 1 44 45 46 47 1 
1 1 1 16 17 18 1 44 45 46 47 1 1 1 1 40 41 42 43 1 
1 1 1 12 13 14 1 40 41 42 43 1 1 1 1 36 37 38 39 1 
1 1 1 8 9 10 1 36 37 38 39 1 16 17 18 1 1 1 1 1 
1 1 1 4 5 6 1 1 1 1 1 1 12 13 14 1 1 1 1 1 
1 1 1 1 1 1 1 1 1 1 1 1 8 9 10 1 1 1 1 1 
1 1 1 1 1 1 1 1 1 1 1 1 4 5 6 1 1 1 1 1 
1 1 1 1 1 1 1 1 1 1 1 1 1 1 1 1 1 1 1 1 
1 48 49 50 51 1 1 16 17 18 1 1 1 1 1 1 1 1 1 1 
1 44 45 46 47 1 1 12 13 14 1 1 1 1 1 1 1 1 1 1 
1 40 41 42 43 1 1 8 9 10 1 1 1 1 1 1 1 1 1 1 
1 36 37 38 39 1 1 4 5 6 1 1 48 49 50 51 1 1 1 1 
1 1 1 1 1 1 1 1 1 1 1 1 44 45 46 47 1 1 1 1 
1 1 1 1 1 1 1 1 1 1 1 1 40 41 42 43 1 1 1 1 
1 1 1 1 1 1 1 1 1 1 1 1 36 37 38 39 1 1 1 1 
1 1 1 1 1 1 1 1 1 1 1 1 1 1 1 1 1 1 1 1 
1 1 1 1 1 1 1 1 1 1 1 1 1 1 1 1 1 1 1 1 
0 0 0 0 0 0 0 0 0 0 0 0 0 0 0 0 0 0 0 0 
0 0 0 0 0 0 0 0 0 0 0 0 0 0 0 0 0 0 0 0 
0 0 0 0 0 0 0 0 0 0 0 0 0 0 0 1 1 1 1 0 
0 0 0 0 0 0 0 1 1 1 1 0 0 0 0 1 1 1 1 0 
0 0 0 1 1 1 0 1 1 1 1 0 0 0 0 1 1 1 1 0 
0 0 0 1 1 1 0 1 1 1 1 0 0 0 0 0 0 0 0 0 
0 0 0 1 1 1 0 0 0 0 0 0 1 1 1 0 0 0 0 0 
0 0 0 0 0 0 0 0 0 0 0 0 1 1 1 0 0 0 0 0 
0 0 0 0 0 0 0 0 0 0 0 0 1 1 1 0 0 0 0 0 
0 0 0 0 0 0 0 0 0 0 0 0 0 0 0 0 0 0 0 0 
0 0 0 0 0 0 0 0 0 0 0 0 0 0 0 0 0 0 0 0 
0 1 1 1 1 0 0 1 1 1 0 0 0 0 0 0 0 0 0 0 
0 1 1 1 1 0 0 1 1 1 0 0 0 0 0 0 0 0 0 0 
0 1 1 1 1 0 0 1 1 1 0 0 0 0 0 0 0 0 0 0 
0 0 0 0 0 0 0 0 0 0 0 0 1 1 1 1 0 0 0 0 
0 0 0 0 0 0 0 0 0 0 0 0 1 1 1 1 0 0 0 0 
0 0 0 0 0 0 0 0 0 0 0 0 1 1 1 1 0 0 0 0 
0 0 0 0 0 0 0 0 0 0 0 0 0 0 0 0 0 0 0 0 
0 0 0 0 0 0 0 0 0 0 0 0 0 0 0 0 0 0 0 0 
0 0 0 0 0 0 0 0 0 0 0 0 0 0 0 0 0 0 0 0 
