32
32
Bigger Town
None
0
1 1 1 1 1 1 1 1 1 1 1 1 1 1 1 1 1 1 1 1 1 1 1 1 1 1 1 1 1 1 1 1 
1 1 1 1 1 1 1 1 1 1 1 1 1 1 1 80 80 80 80 80 80 80 80 80 80 80 1 1 1 1 1 1 
1 1 1 1 1 1 1 1 1 1 1 1 1 1 1 80 1 1 1 1 1 1 1 1 1 80 1 1 1 1 1 1 
1 1 1 1 1 1 1 1 1 1 1 1 1 1 1 80 1 1 1 1 1 1 1 60 61 61 61 62 1 1 1 1 
1 1 1 1 1 1 1 1 1 80 80 80 80 80 80 80 1 1 1 1 1 1 1 56 57 57 57 58 1 1 1 1 
1 1 1 1 1 1 1 1 80 80 1 1 1 1 1 80 1 1 1 1 1 1 1 56 57 57 57 58 1 1 1 1 
1 1 1 1 1 1 1 1 80 1 1 1 1 1 1 80 1 1 1 1 1 1 1 56 57 57 57 58 1 1 1 1 
1 1 1 1 1 1 1 48 33 34 35 1 1 1 1 80 1 1 1 1 1 1 1 56 57 57 57 58 1 1 1 1 
1 1 1 1 1 1 1 28 29 30 31 1 1 1 1 80 1 1 1 1 1 1 1 56 57 57 57 58 1 1 1 1 
1 1 1 1 1 1 1 24 25 26 27 1 1 1 1 80 1 1 1 1 1 1 1 52 53 53 53 54 1 1 1 1 
1 1 1 1 1 1 1 20 21 21 23 1 1 1 1 80 1 1 1 1 1 1 1 1 1 1 1 1 1 1 1 1 
1 1 1 1 1 1 1 1 1 1 1 1 1 1 1 80 1 1 1 1 1 1 1 1 1 1 1 1 1 1 1 1 
1 1 1 1 1 1 1 1 1 1 1 1 1 1 1 80 1 1 1 1 1 1 1 1 1 1 1 1 1 1 1 1 
1 1 1 1 1 1 1 1 1 1 1 1 1 1 1 80 1 1 1 1 1 1 1 1 1 1 1 1 1 1 1 1 
1 1 1 1 1 1 1 1 1 1 1 1 1 1 1 80 1 1 1 1 1 1 1 1 1 1 1 1 1 1 1 1 
1 1 1 1 1 1 1 1 1 1 1 1 1 1 1 80 1 1 1 1 1 1 1 1 1 1 1 1 1 1 1 1 
1 1 1 1 1 1 1 1 1 1 1 1 1 1 1 80 1 1 1 1 1 1 1 1 1 1 1 1 1 1 1 1 
1 1 1 1 1 1 1 80 80 80 80 80 80 80 80 80 80 80 80 80 80 80 80 80 80 1 1 1 1 1 1 1 
1 1 1 1 1 1 1 80 1 1 1 1 1 1 1 1 1 1 1 1 1 1 1 1 80 1 1 1 1 1 1 1 
1 1 1 1 1 1 1 80 1 1 1 1 1 1 1 15 1 1 1 1 1 1 1 1 80 1 1 1 1 1 1 1 
1 1 1 1 1 1 1 80 1 1 1 1 1 1 1 1 1 1 1 1 1 1 1 1 80 1 1 1 1 1 1 1 
1 1 1 1 1 1 1 80 1 1 1 1 1 1 1 1 1 1 1 1 1 1 1 1 80 1 1 1 1 1 1 1 
1 1 1 1 1 1 1 80 1 1 1 1 1 1 1 1 1 1 1 1 1 1 1 1 80 1 1 1 1 1 1 1 
1 1 1 1 1 1 48 49 50 51 1 1 1 1 1 1 1 1 1 1 1 16 72 72 17 72 72 18 1 1 1 1 
1 1 1 1 1 1 44 45 46 47 1 1 1 1 1 1 1 1 1 1 1 12 68 68 13 68 68 14 1 1 1 1 
1 1 1 1 1 1 40 41 42 43 1 1 1 1 1 1 1 1 1 1 1 8 9 9 9 9 9 10 1 1 1 1 
1 1 1 1 1 1 36 37 38 39 1 1 1 1 1 1 1 1 1 1 1 4 5 5 5 5 5 6 1 1 1 1 
1 1 1 1 1 1 1 1 1 1 1 1 1 1 1 1 1 1 1 1 1 1 1 1 1 1 1 1 1 1 1 1 
1 1 1 1 1 1 1 1 1 1 1 1 1 1 1 1 1 1 1 1 1 1 1 1 1 1 1 1 1 1 1 1 
1 1 1 1 1 1 1 1 1 1 1 1 1 1 1 1 1 1 1 1 1 1 1 1 1 1 1 1 1 1 1 1 
74 74 74 74 74 74 74 74 74 74 74 74 74 74 74 74 74 74 74 74 74 74 74 74 74 74 74 74 74 74 74 74 
70 70 70 70 70 70 70 70 70 70 70 70 70 70 70 70 70 70 70 70 70 70 70 70 70 70 70 70 70 70 70 70 
0 0 0 0 0 0 0 0 0 0 0 0 0 0 0 0 0 0 0 0 0 0 0 0 0 0 0 0 0 0 0 0 
0 0 0 0 0 0 0 0 0 0 0 0 0 0 0 0 0 0 0 0 0 0 0 0 0 0 0 0 0 0 0 0 
0 0 0 0 0 0 0 0 0 0 0 0 0 0 0 0 0 0 0 0 0 0 0 0 0 0 0 0 0 0 0 0 
0 0 0 0 0 0 0 0 0 0 0 0 0 0 0 0 0 0 0 0 0 0 0 1 1 1 1 1 0 0 0 0 
0 0 0 0 0 0 0 0 0 0 0 0 0 0 0 0 0 0 0 0 0 0 0 1 1 1 1 1 0 0 0 0 
0 0 0 0 0 0 0 0 0 0 0 0 0 0 0 0 0 0 0 0 0 0 0 1 1 1 1 1 0 0 0 0 
0 0 0 0 0 0 0 0 0 0 0 0 0 0 0 0 0 0 0 0 0 0 0 1 1 1 1 1 0 0 0 0 
0 0 0 0 0 0 0 1 1 1 1 0 0 0 0 0 0 0 0 0 0 0 0 1 1 1 1 1 0 0 0 0 
0 0 0 0 0 0 0 1 1 1 1 0 0 0 0 0 0 0 0 0 0 0 0 1 1 1 1 1 0 0 0 0 
0 0 0 0 0 0 0 1 1 1 1 0 0 0 0 0 0 0 0 0 0 0 0 1 1 1 1 1 0 0 0 0 
0 0 0 0 0 0 0 0 0 0 0 0 0 0 0 0 0 0 0 0 0 0 0 0 0 0 0 0 0 0 0 0 
0 0 0 0 0 0 0 0 0 0 0 0 0 0 0 0 0 0 0 0 0 0 0 0 0 0 0 0 0 0 0 0 
0 0 0 0 0 0 0 0 0 0 0 0 0 0 0 0 0 0 0 0 0 0 0 0 0 0 0 0 0 0 0 0 
0 0 0 0 0 0 0 0 0 0 0 0 0 0 0 0 0 0 0 0 0 0 0 0 0 0 0 0 0 0 0 0 
0 0 0 0 0 0 0 0 0 0 0 0 0 0 0 0 0 0 0 0 0 0 0 0 0 0 0 0 0 0 0 0 
0 0 0 0 0 0 0 0 0 0 0 0 0 0 0 0 0 0 0 0 0 0 0 0 0 0 0 0 0 0 0 0 
0 0 0 0 0 0 0 0 0 0 0 0 0 0 0 0 0 0 0 0 0 0 0 0 0 0 0 0 0 0 0 0 
0 0 0 0 0 0 0 0 0 0 0 0 0 0 0 0 0 0 0 0 0 0 0 0 0 0 0 0 0 0 0 0 
0 0 0 0 0 0 0 0 0 0 0 0 0 0 0 0 0 0 0 0 0 0 0 0 0 0 0 0 0 0 0 0 
0 0 0 0 0 0 0 0 0 0 0 0 0 0 0 1 0 0 0 0 0 0 0 0 0 0 0 0 0 0 0 0 
0 0 0 0 0 0 0 0 0 0 0 0 0 0 0 0 0 0 0 0 0 0 0 0 0 0 0 0 0 0 0 0 
0 0 0 0 0 0 0 0 0 0 0 0 0 0 0 0 0 0 0 0 0 0 0 0 0 0 0 0 0 0 0 0 
0 0 0 0 0 0 0 0 0 0 0 0 0 0 0 0 0 0 0 0 0 0 0 0 0 0 0 0 0 0 0 0 
0 0 0 0 0 0 1 1 1 1 0 0 0 0 0 0 0 0 0 0 0 1 1 1 0 1 1 1 0 0 0 0 
0 0 0 0 0 0 1 1 1 1 0 0 0 0 0 0 0 0 0 0 0 1 1 1 1 1 1 1 0 0 0 0 
0 0 0 0 0 0 1 1 1 1 0 0 0 0 0 0 0 0 0 0 0 1 1 1 1 1 1 1 0 0 0 0 
0 0 0 0 0 0 0 0 0 0 0 0 0 0 0 0 0 0 0 0 0 1 1 1 1 1 1 1 0 0 0 0 
0 0 0 0 0 0 0 0 0 0 0 0 0 0 0 0 0 0 0 0 0 0 0 0 0 0 0 0 0 0 0 0 
0 0 0 0 0 0 0 0 0 0 0 0 0 0 0 0 0 0 0 0 0 0 0 0 0 0 0 0 0 0 0 0 
0 0 0 0 0 0 0 0 0 0 0 0 0 0 0 0 0 0 0 0 0 0 0 0 0 0 0 0 0 0 0 0 
1 1 1 1 1 1 1 1 1 1 1 1 1 1 1 1 1 1 1 1 1 1 1 1 1 1 1 1 1 1 1 1 
1 1 1 1 1 1 1 1 1 1 1 1 1 1 1 1 1 1 1 1 1 1 1 1 1 1 1 1 1 1 1 1 
warp null 24 23
connect justin up -3 32
connect OnlyGrass down 0 -20
connect Maze left -20 12
connect PokeParty right 32 23
