35
35
Justin's Map
None
1
1 1 1 1 1 1 1 1 1 1 1 1 1 1 1 1 1 1 1 1 1 1 1 1 1 1 1 1 1 1 1 1 1 1 1 
1 1 1 1 1 1 1 1 80 80 1 1 1 1 1 1 1 1 1 1 1 1 1 1 1 1 1 1 1 1 1 1 1 1 1 
1 1 1 80 80 80 80 80 80 80 1 1 1 1 1 1 1 1 1 1 1 1 1 1 1 1 1 1 1 1 1 1 1 1 1 
1 1 1 80 1 1 1 1 1 80 80 1 1 1 1 1 1 1 1 1 1 1 1 1 1 1 1 1 1 1 1 1 1 1 1 
1 1 48 33 34 35 1 1 1 1 80 1 1 1 1 1 1 1 1 1 1 1 1 1 1 1 1 1 1 1 1 1 1 1 1 
1 1 28 29 30 31 1 1 1 1 1 80 1 1 1 1 1 1 1 1 1 1 1 1 1 1 1 1 1 1 1 1 1 1 1 
1 1 24 25 26 27 1 1 1 1 1 80 80 1 1 1 1 1 1 1 1 1 1 1 1 1 1 1 1 1 1 1 1 1 1 
1 1 20 21 21 23 1 1 1 1 1 1 1 80 1 1 1 1 1 1 1 1 1 1 1 1 1 1 1 1 1 1 1 1 1 
1 1 1 1 1 1 1 1 1 1 1 1 1 80 80 1 1 1 1 1 1 1 1 1 1 1 1 1 1 80 80 80 1 1 1 
1 1 1 1 1 1 1 1 1 1 1 1 1 1 1 80 1 1 1 1 1 1 1 80 80 80 80 80 80 80 1 80 80 1 1 
1 1 1 1 1 1 1 1 1 1 1 1 1 1 1 80 1 1 1 1 1 80 80 80 1 1 1 80 1 1 1 80 80 1 1 
1 1 1 1 1 1 1 1 1 1 1 1 1 1 80 80 80 80 80 80 80 80 80 1 1 1 80 80 1 1 48 33 34 35 1 
1 1 1 1 1 1 1 1 1 1 1 1 80 80 80 80 80 80 1 1 1 1 80 80 1 1 80 1 1 1 28 29 30 31 1 
1 1 1 1 1 1 1 1 1 80 80 80 80 1 1 1 80 1 1 1 1 1 1 80 80 1 80 1 1 1 24 25 26 27 1 
1 1 1 1 1 1 1 80 80 80 1 80 1 1 1 1 80 1 1 1 1 1 1 1 80 1 80 80 1 1 20 21 21 23 1 
1 1 1 1 80 80 80 80 1 1 1 80 1 1 1 48 33 34 35 1 1 1 1 80 80 1 1 80 1 1 1 1 1 1 1 
1 1 1 80 80 1 1 1 1 1 1 80 80 1 1 28 29 30 31 1 1 1 1 80 1 1 1 80 1 1 1 1 1 1 1 
1 1 1 80 1 1 1 1 1 1 1 1 80 1 1 24 25 26 27 1 1 1 1 80 1 1 1 80 1 1 1 1 1 1 1 
1 1 1 80 1 1 1 1 1 1 1 1 80 1 1 20 21 21 23 1 1 1 80 80 1 1 1 80 1 1 1 1 1 1 1 
1 1 1 80 80 1 1 1 1 1 1 1 80 80 1 1 1 1 1 1 1 1 80 1 1 1 1 80 1 1 1 1 1 1 1 
1 1 1 1 80 1 1 1 1 1 1 1 1 80 1 1 1 1 1 1 1 80 80 1 1 1 1 80 1 1 1 1 1 1 1 
1 1 1 1 80 1 1 1 1 1 1 1 1 80 1 1 1 1 1 1 1 80 1 1 1 1 1 80 1 1 1 1 1 1 1 
1 1 1 48 33 34 35 1 1 1 1 1 1 80 1 1 1 1 1 1 80 80 1 1 1 1 1 80 1 1 1 1 1 1 1 
1 1 1 28 29 30 31 1 1 1 1 1 1 80 1 1 1 1 1 48 49 50 51 1 1 1 48 33 34 35 1 1 1 1 1 
1 1 1 24 25 26 27 1 1 1 1 1 1 80 1 1 1 1 1 44 45 46 47 1 1 1 28 29 30 31 1 1 1 1 1 
1 1 1 20 21 21 23 1 1 1 1 1 1 80 1 1 1 1 1 40 41 42 43 1 1 1 24 25 26 27 1 1 1 1 1 
1 1 1 1 1 1 1 1 1 1 1 1 80 80 1 1 1 1 1 36 37 38 39 1 1 1 20 21 21 23 1 1 1 1 1 
1 1 1 1 1 1 1 1 1 1 1 1 48 49 50 51 1 1 1 1 1 1 1 1 1 1 1 1 1 1 1 1 1 1 1 
1 1 1 1 1 1 1 1 1 1 1 1 44 45 46 47 1 1 1 1 1 1 1 1 1 1 1 1 1 1 1 1 1 1 1 
1 1 1 1 1 1 1 1 1 1 1 1 40 41 42 43 1 1 1 1 1 1 1 1 1 1 1 1 1 1 1 1 1 1 1 
1 1 1 1 1 1 1 1 1 1 1 1 36 37 38 39 1 1 1 1 1 1 1 1 1 1 1 1 1 1 1 1 1 1 1 
1 1 1 1 1 1 1 1 1 1 1 1 1 1 1 1 1 1 1 1 1 1 1 1 1 1 1 1 1 1 1 1 1 1 1 
1 1 1 1 1 1 1 1 1 1 1 1 1 1 1 1 1 1 1 1 1 1 1 1 1 1 1 1 1 1 1 1 1 1 1 
1 1 1 1 1 1 1 1 1 1 1 1 1 1 1 1 1 1 1 1 1 1 1 1 1 1 1 1 1 1 1 1 1 1 1 
1 1 1 1 1 1 1 1 1 1 1 1 1 1 1 1 1 1 1 1 1 1 1 1 1 1 1 1 1 1 1 1 1 1 1 
0 0 0 0 0 0 0 0 0 0 0 0 0 0 0 0 0 0 0 0 0 0 0 0 0 0 0 0 0 0 0 0 0 0 0 
0 0 0 0 0 0 0 0 0 0 0 0 0 0 0 0 0 0 0 0 0 0 0 0 0 0 0 0 0 0 0 0 0 0 0 
0 0 0 0 0 0 0 0 0 0 0 0 0 0 0 0 0 0 0 0 0 0 0 0 0 0 0 0 0 0 0 0 0 0 0 
0 0 0 0 0 0 0 0 0 0 0 0 0 0 0 0 0 0 0 0 0 0 0 0 0 0 0 0 0 0 0 0 0 0 0 
0 0 1 1 1 1 0 0 0 0 0 0 0 0 0 0 0 0 0 0 0 0 0 0 0 0 0 0 0 0 0 0 0 0 0 
0 0 1 1 1 1 0 0 0 0 0 0 0 0 0 0 0 0 0 0 0 0 0 0 0 0 0 0 0 0 0 0 0 0 0 
0 0 1 1 1 1 0 0 0 0 0 0 0 0 0 0 0 0 0 0 0 0 0 0 0 0 0 0 0 0 0 0 0 0 0 
0 0 0 0 0 0 0 0 0 0 0 0 0 0 0 0 0 0 0 0 0 0 0 0 0 0 0 0 0 0 0 0 0 0 0 
0 0 0 0 0 0 0 0 0 0 0 0 0 0 0 0 0 0 0 0 0 0 0 0 0 0 0 0 0 0 0 0 0 0 0 
0 0 0 0 0 0 0 0 0 0 0 0 0 0 0 0 0 0 0 0 0 0 0 0 0 0 0 0 0 0 0 0 0 0 0 
0 0 0 0 0 0 0 0 0 0 0 0 0 0 0 0 0 0 0 0 0 0 0 0 0 0 0 0 0 0 0 0 0 0 0 
0 0 0 0 0 0 0 0 0 0 0 0 0 0 0 0 0 0 0 0 0 0 0 0 0 0 0 0 0 0 1 1 1 1 0 
0 0 0 0 0 0 0 0 0 0 0 0 0 0 0 0 0 0 0 0 0 0 0 0 0 0 0 0 0 0 1 1 1 1 0 
0 0 0 0 0 0 0 0 0 0 0 0 0 0 0 0 0 0 0 0 0 0 0 0 0 0 0 0 0 0 1 1 1 1 0 
0 0 0 0 0 0 0 0 0 0 0 0 0 0 0 0 0 0 0 0 0 0 0 0 0 0 0 0 0 0 0 0 0 0 0 
0 0 0 0 0 0 0 0 0 0 0 0 0 0 0 1 1 1 1 0 0 0 0 0 0 0 0 0 0 0 0 0 0 0 0 
0 0 0 0 0 0 0 0 0 0 0 0 0 0 0 1 1 1 1 0 0 0 0 0 0 0 0 0 0 0 0 0 0 0 0 
0 0 0 0 0 0 0 0 0 0 0 0 0 0 0 1 1 1 1 0 0 0 0 0 0 0 0 0 0 0 0 0 0 0 0 
0 0 0 0 0 0 0 0 0 0 0 0 0 0 0 0 0 0 0 0 0 0 0 0 0 0 0 0 0 0 0 0 0 0 0 
0 0 0 0 0 0 0 0 0 0 0 0 0 0 0 0 0 0 0 0 0 0 0 0 0 0 0 0 0 0 0 0 0 0 0 
0 0 0 0 0 0 0 0 0 0 0 0 0 0 0 0 0 0 0 0 0 0 0 0 0 0 0 0 0 0 0 0 0 0 0 
0 0 0 0 0 0 0 0 0 0 0 0 0 0 0 0 0 0 0 0 0 0 0 0 0 0 0 0 0 0 0 0 0 0 0 
0 0 0 1 1 1 1 0 0 0 0 0 0 0 0 0 0 0 0 0 0 0 0 0 0 0 0 0 0 0 0 0 0 0 0 
0 0 0 1 1 1 1 0 0 0 0 0 0 0 0 0 0 0 0 1 1 1 1 0 0 0 1 1 1 1 0 0 0 0 0 
0 0 0 1 1 1 1 0 0 0 0 0 0 0 0 0 0 0 0 1 1 1 1 0 0 0 1 1 1 1 0 0 0 0 0 
0 0 0 0 0 0 0 0 0 0 0 0 0 0 0 0 0 0 0 1 1 1 1 0 0 0 1 1 1 1 0 0 0 0 0 
0 0 0 0 0 0 0 0 0 0 0 0 0 0 0 0 0 0 0 0 0 0 0 0 0 0 0 0 0 0 0 0 0 0 0 
0 0 0 0 0 0 0 0 0 0 0 0 1 1 1 1 0 0 0 0 0 0 0 0 0 0 0 0 0 0 0 0 0 0 0 
0 0 0 0 0 0 0 0 0 0 0 0 1 1 1 1 0 0 0 0 0 0 0 0 0 0 0 0 0 0 0 0 0 0 0 
0 0 0 0 0 0 0 0 0 0 0 0 1 1 1 1 0 0 0 0 0 0 0 0 0 0 0 0 0 0 0 0 0 0 0 
0 0 0 0 0 0 0 0 0 0 0 0 0 0 0 0 0 0 0 0 0 0 0 0 0 0 0 0 0 0 0 0 0 0 0 
0 0 0 0 0 0 0 0 0 0 0 0 0 0 0 0 0 0 0 0 0 0 0 0 0 0 0 0 0 0 0 0 0 0 0 
0 0 0 0 0 0 0 0 0 0 0 0 0 0 0 0 0 0 0 0 0 0 0 0 0 0 0 0 0 0 0 0 0 0 0 
0 0 0 0 0 0 0 0 0 0 0 0 0 0 0 0 0 0 0 0 0 0 0 0 0 0 0 0 0 0 0 0 0 0 0 
0 0 0 0 0 0 0 0 0 0 0 0 0 0 0 0 0 0 0 0 0 0 0 0 0 0 0 0 0 0 0 0 0 0 0 
npc jo 16 19 NESS walk_up_and_down yoyoyo
connect PokeParty right 35 -12
connect Bigger_Town down 3 -32
connect Maze up 6 35
