20
20
Maze
None
1
226 70 70 70 70 70 70 70 70 70 70 70 70 70 70 70 70 70 70 226 
227 1 1 1 1 1 1 1 1 1 1 1 1 1 1 1 1 1 1 226 
227 1 74 74 74 74 74 74 1 74 74 74 74 74 74 74 74 74 1 226 
227 1 227 70 70 70 70 70 1 70 70 70 70 70 70 70 70 227 1 226 
227 1 227 1 74 74 74 74 74 74 74 74 1 74 74 74 1 227 1 70 
227 1 227 1 227 70 70 70 70 70 70 70 1 227 70 227 1 70 1 1 
227 1 227 1 227 1 74 74 74 74 1 74 74 227 1 227 1 74 1 75 
227 1 70 1 227 1 227 70 70 70 1 70 70 227 1 227 1 227 1 226 
227 1 74 1 227 1 227 1 74 74 74 74 1 227 1 70 1 227 1 226 
227 1 227 1 227 1 227 1 227 70 70 227 1 227 1 74 1 227 1 226 
227 1 227 1 70 1 227 1 227 1 1 227 1 70 1 227 1 227 1 226 
227 1 227 1 74 1 70 1 227 74 1 227 1 74 1 227 1 227 1 226 
227 1 227 1 227 1 74 1 70 70 1 70 1 227 1 227 1 227 1 226 
227 1 227 1 227 1 227 74 74 74 74 74 74 227 1 227 1 227 1 226 
227 1 227 1 227 1 70 70 70 70 70 70 70 70 1 227 1 227 1 226 
227 1 227 1 227 74 74 74 74 1 74 74 74 74 74 227 1 227 1 226 
227 1 227 1 70 70 70 70 70 1 70 70 70 70 70 70 1 227 1 226 
227 1 74 74 74 74 74 74 74 74 74 74 1 74 74 74 74 227 1 226 
227 1 70 70 70 70 70 70 70 70 70 70 1 70 70 70 70 70 1 226 
227 74 74 74 74 74 74 74 74 74 74 74 74 74 74 74 74 74 74 226 
1 1 1 1 1 1 1 1 1 1 1 1 1 1 1 1 1 1 1 1 
1 0 0 0 0 0 0 0 0 0 0 0 0 0 0 0 0 0 0 1 
1 0 1 1 1 1 1 1 0 1 1 1 1 1 1 1 1 1 0 1 
1 0 1 0 0 0 0 0 0 0 0 0 0 0 0 0 0 1 0 1 
1 0 1 0 1 1 1 1 1 1 1 1 0 1 1 1 0 0 0 1 
1 0 1 0 1 0 0 0 0 0 0 0 0 0 0 1 0 0 0 0 
1 0 1 0 1 0 1 1 1 1 0 1 1 1 0 1 0 1 0 1 
1 0 0 0 1 0 1 0 0 0 0 0 0 1 0 1 0 1 0 1 
1 0 1 0 1 0 1 0 1 1 1 1 0 1 0 0 0 1 0 1 
1 0 1 0 1 0 1 0 1 0 0 1 0 1 0 1 0 1 0 1 
1 0 1 0 0 0 1 0 1 0 0 1 0 0 0 1 0 1 0 1 
1 0 1 0 1 0 0 0 1 1 0 1 0 1 0 1 0 1 0 1 
1 0 1 0 1 0 1 0 0 0 0 0 0 1 0 1 0 1 0 1 
1 0 1 0 1 0 1 1 1 1 1 1 1 1 0 1 0 1 0 1 
1 0 1 0 1 0 0 0 0 0 0 0 0 0 0 1 0 1 0 1 
1 0 1 0 1 1 1 1 1 0 1 1 1 1 1 1 0 1 0 1 
1 0 1 0 0 0 0 0 0 0 0 0 0 0 0 0 0 1 0 1 
1 0 1 1 1 1 1 1 1 1 1 1 0 1 1 1 1 1 0 1 
1 0 0 0 0 0 0 0 0 0 0 0 0 0 0 0 0 0 0 1 
1 1 1 1 1 1 1 1 1 1 1 1 1 1 1 1 1 1 1 1 
/connect Bigger_Town right 20 0
