20
20
Test
None
1
1 1 1 1 1 1 1 1 1 1 1 1 1 1 1 1 1 1 1 1 
1 1 1 1 1 1 1 1 1 1 1 1 1 1 1 1 1 1 1 1 
1 1 172 173 174 1 1 1 1 1 1 1 1 1 1 1 1 1 1 1 
1 1 168 169 170 1 1 16 17 18 1 1 1 1 16 17 18 1 1 1 
1 1 164 165 166 1 1 12 13 14 1 1 1 1 12 13 14 1 1 1 
1 1 1 1 1 1 1 8 9 10 1 1 1 1 8 9 10 1 1 1 
1 1 1 1 1 1 1 4 5 6 1 1 1 1 4 5 6 1 1 1 
1 1 1 1 1 1 1 1 1 1 1 1 1 1 1 1 1 1 1 1 
1 1 1 1 1 1 172 173 174 1 1 1 1 1 1 1 1 1 1 1 
1 1 1 1 1 1 168 169 170 1 1 1 1 1 1 1 1 1 1 1 
1 1 1 1 1 1 164 165 166 1 1 1 1 1 1 1 172 173 174 1 
1 1 1 1 1 1 1 1 1 1 1 1 1 1 1 1 168 169 170 1 
1 1 16 17 18 1 1 1 1 1 1 1 16 17 18 1 164 165 166 1 
1 1 12 13 14 1 1 1 1 1 1 1 12 13 14 1 1 1 1 1 
1 1 8 9 10 1 1 1 1 1 1 1 8 9 10 1 1 1 1 1 
1 1 4 5 6 1 60 61 62 1 1 1 4 5 6 1 1 1 1 1 
1 1 1 1 1 1 56 57 58 1 1 1 1 1 1 1 1 1 1 1 
1 1 1 1 1 1 52 53 54 1 1 1 1 1 1 1 1 1 1 1 
1 1 1 1 1 1 1 1 1 1 1 1 1 1 1 1 1 1 1 1 
1 1 1 1 1 1 1 1 1 1 1 1 1 1 1 1 1 1 1 1 
0 0 0 0 0 0 0 0 0 0 0 0 0 0 0 0 0 0 0 0 
0 0 0 0 0 0 0 0 0 0 0 0 0 0 0 0 0 0 0 0 
0 0 0 0 0 0 0 0 0 0 0 0 0 0 0 0 0 0 0 0 
0 0 0 0 0 0 0 1 1 1 0 0 0 0 1 1 1 0 0 0 
0 0 0 0 0 0 0 1 1 1 0 0 0 0 1 1 1 0 0 0 
0 0 0 0 0 0 0 1 1 1 0 0 0 0 1 1 1 0 0 0 
0 0 0 0 0 0 0 0 0 0 0 0 0 0 0 0 0 0 0 0 
0 0 0 0 0 0 0 0 0 0 0 0 0 0 0 0 0 0 0 0 
0 0 0 0 0 0 0 0 0 0 0 0 0 0 0 0 0 0 0 0 
0 0 0 0 0 0 0 0 0 0 0 0 0 0 0 0 0 0 0 0 
0 0 0 0 0 0 0 0 0 0 0 0 0 0 0 0 0 0 0 0 
0 0 0 0 0 0 0 0 0 0 0 0 0 0 0 0 0 0 0 0 
0 0 1 1 1 0 0 0 0 0 0 0 1 1 1 0 0 0 0 0 
0 0 1 1 1 0 0 0 0 0 0 0 1 1 1 0 0 0 0 0 
0 0 1 1 1 0 0 0 0 0 0 0 1 1 1 0 0 0 0 0 
0 0 0 0 0 0 1 1 1 0 0 0 0 0 0 0 0 0 0 0 
0 0 0 0 0 0 1 1 1 0 0 0 0 0 0 0 0 0 0 0 
0 0 0 0 0 0 1 1 1 0 0 0 0 0 0 0 0 0 0 0 
0 0 0 0 0 0 0 0 0 0 0 0 0 0 0 0 0 0 0 0 
0 0 0 0 0 0 0 0 0 0 0 0 0 0 0 0 0 0 0 0 
/npc ashe 2 7 POKEMON walk_left_and_right hohoho
/npc ness 11 7 NESS walk_up_and_down pk_fire
/npc jogger_joe 18 10 POKEMON jog_no_sleep cant_talk
/npc mess 8 12 NESS walk_around quick
enemy 17 17 BLUE_DETRAL chaser 5
sign 7 15 This is a test message.
