20
20
Only Grass
Robbers!
1
226 227 226 227 227 227 226 227 226 227 227 227 227 226 227 227 226 227 226 227 
226 227 70 71 70 71 70 71 70 71 70 71 70 71 70 71 70 71 226 227 
226 227 1 1 1 1 1 1 1 1 1 1 1 1 1 1 1 1 226 227 
226 227 1 1 1 1 1 1 1 1 1 1 1 1 1 1 1 1 226 227 
226 227 1 1 1 1 1 1 1 1 1 1 1 1 1 1 1 1 226 227 
226 227 1 1 1 1 1 1 1 1 1 1 1 1 1 1 1 1 226 227 
226 227 1 1 1 1 1 1 1 1 1 1 1 1 1 1 1 1 226 227 
226 227 1 1 1 1 1 1 1 1 1 1 1 1 1 1 1 1 226 227 
226 227 1 1 1 1 1 1 1 1 1 1 1 1 1 1 1 1 226 227 
226 227 1 1 1 1 1 1 1 1 1 1 1 1 1 1 1 1 226 227 
226 227 1 1 1 1 1 1 1 1 1 1 1 1 1 1 1 1 226 227 
226 227 1 1 1 1 1 1 1 1 1 1 1 1 1 1 1 1 226 227 
226 227 1 1 1 1 1 1 1 1 1 1 1 1 1 1 1 1 226 227 
226 227 1 1 1 1 1 1 1 1 1 1 1 1 1 1 1 1 226 227 
226 227 1 1 1 1 1 1 1 1 1 1 1 1 1 1 1 1 226 227 
226 227 1 1 1 1 1 1 1 1 1 1 1 1 1 1 1 1 226 227 
226 227 1 1 1 1 1 1 1 1 1 1 1 1 1 1 1 1 226 227 
226 227 1 1 1 1 1 1 1 1 1 1 1 1 1 1 1 1 226 227 
226 227 74 75 74 75 74 75 1 1 74 75 74 75 74 75 74 75 226 227 
227 227 227 227 227 227 227 227 1 1 227 227 227 227 227 227 227 227 227 227 
1 1 1 1 1 1 1 1 1 1 1 1 1 1 1 1 1 1 1 1 
1 1 1 1 1 1 1 1 1 1 1 1 1 1 1 1 1 1 1 1 
1 1 0 0 0 0 0 0 0 0 0 0 0 0 0 0 0 0 1 1 
1 1 0 0 0 0 0 0 0 0 0 0 0 0 0 0 0 0 1 1 
1 1 0 0 0 0 0 0 0 0 0 0 0 0 0 0 0 0 1 1 
1 1 0 0 0 0 0 0 0 0 0 0 0 0 0 0 0 0 1 1 
1 1 0 0 0 0 0 0 0 0 0 0 0 0 0 0 0 0 1 1 
1 1 0 0 0 0 0 0 0 0 0 0 0 0 0 0 0 0 1 1 
1 1 0 0 0 0 0 0 0 0 0 0 0 0 0 0 0 0 1 1 
1 1 0 0 0 0 0 0 0 0 0 0 0 0 0 0 0 0 1 1 
1 1 0 0 0 0 0 0 0 0 0 0 0 0 0 0 0 0 1 1 
1 1 0 0 0 0 0 0 0 0 0 0 0 0 0 0 0 0 1 1 
1 1 0 0 0 0 0 0 0 0 0 0 0 0 0 0 0 0 1 1 
1 1 0 0 0 0 0 0 0 0 0 0 0 0 0 0 0 0 1 1 
1 1 0 0 0 0 0 0 0 0 0 0 0 0 0 0 0 0 1 1 
1 1 0 0 0 0 0 0 0 0 0 0 0 0 0 0 0 0 1 1 
1 1 0 0 0 0 0 0 0 0 0 0 0 0 0 0 0 0 1 1 
1 1 0 0 0 0 0 0 0 0 0 0 0 0 0 0 0 0 1 1 
1 1 1 1 1 1 1 1 0 0 1 1 1 1 1 1 1 1 1 1 
1 1 1 1 1 1 1 1 0 0 1 1 1 1 1 1 1 1 1 1 
sign 2 18 This is a forest
connect Bigger_Town up 0 20
