20
20
Only Grass
None
1
226 227 226 227 227 227 226 227 226 227 227 227 227 226 227 227 226 227 226 227 
226 227 70 71 70 71 70 71 70 71 70 71 70 71 70 71 70 71 226 227 
226 227 1 1 1 1 1 1 1 1 1 1 1 1 1 1 1 1 226 227 
226 227 1 1 1 1 1 1 1 1 1 1 1 1 1 1 1 1 226 227 
226 227 1 1 1 1 1 1 1 1 1 1 1 1 1 1 1 1 226 227 
226 227 1 1 1 1 1 1 1 1 1 1 1 1 1 1 1 1 226 227 
226 227 1 1 1 1 1 1 1 1 1 1 1 1 1 1 1 1 226 227 
226 227 1 1 1 1 1 1 1 1 1 1 1 1 1 1 1 1 226 227 
226 227 1 1 1 1 1 1 1 1 1 1 1 1 1 1 1 1 226 227 
226 227 1 1 1 1 1 1 1 1 1 1 1 1 1 1 1 1 226 227 
226 227 1 1 1 1 1 1 1 1 1 1 1 1 1 1 1 1 226 227 
226 227 1 1 1 1 1 1 1 1 1 1 1 1 1 1 1 1 226 227 
226 227 1 1 1 1 1 1 1 1 1 1 1 1 1 1 1 1 226 227 
226 227 1 1 1 1 1 1 1 1 1 1 1 1 1 1 1 1 226 227 
226 227 1 1 1 1 1 1 1 1 1 1 1 1 1 1 1 1 226 227 
226 227 1 1 1 1 1 1 1 1 1 1 1 1 1 1 1 1 226 227 
226 227 1 1 1 1 1 1 1 1 1 1 1 1 1 1 1 1 226 227 
226 227 1 1 1 1 1 1 1 1 1 1 1 1 1 1 1 1 226 227 
226 227 74 75 74 75 74 75 74 75 74 75 74 75 74 75 74 75 226 227 
227 227 227 227 227 227 227 227 227 227 227 227 227 227 227 227 227 227 227 227 
1 1 1 1 1 1 1 1 1 1 1 1 1 1 1 1 1 1 1 1 
1 1 1 1 1 1 1 1 1 1 1 1 1 1 1 1 1 1 1 1 
1 1 0 0 0 0 0 0 0 0 0 0 0 0 0 0 0 0 1 1 
1 1 0 0 0 0 0 0 0 0 0 0 0 0 0 0 0 0 1 1 
1 1 0 0 0 0 0 0 0 0 0 0 0 0 0 0 0 0 1 1 
1 1 0 0 0 0 0 0 0 0 0 0 0 0 0 0 0 0 1 1 
1 1 0 0 0 0 0 0 0 0 0 0 0 0 0 0 0 0 1 1 
1 1 0 0 0 0 0 0 0 0 0 0 0 0 0 0 0 0 1 1 
1 1 0 0 0 0 0 0 0 0 0 0 0 0 0 0 0 0 1 1 
1 1 0 0 0 0 0 0 0 0 0 0 0 0 0 0 0 0 1 1 
1 1 0 0 0 0 0 0 0 0 0 0 0 0 0 0 0 0 1 1 
1 1 0 0 0 0 0 0 0 0 0 0 0 0 0 0 0 0 1 1 
1 1 0 0 0 0 0 0 0 0 0 0 0 0 0 0 0 0 1 1 
1 1 0 0 0 0 0 0 0 0 0 0 0 0 0 0 0 0 1 1 
1 1 0 0 0 0 0 0 0 0 0 0 0 0 0 0 0 0 1 1 
1 1 0 0 0 0 0 0 0 0 0 0 0 0 0 0 0 0 1 1 
1 1 0 0 0 0 0 0 0 0 0 0 0 0 0 0 0 0 1 1 
1 1 0 0 0 0 0 0 0 0 0 0 0 0 0 0 0 0 1 1 
1 1 1 1 1 1 1 1 1 1 1 1 1 1 1 1 1 1 1 1 
1 1 1 1 1 1 1 1 1 1 1 1 1 1 1 1 1 1 1 1 
enemy 16 16 SATURN chaser 3
enemy 5 15 SATURN chaser 6
enemy 13 6 SATURN chaser 5
sign 2 18 This is a forest
connect Bigger_Town up 0 20
