20
20
Test Grass Field
The Forest
1
226 227 226 227 227 227 226 227 226 227 227 227 227 226 227 227 226 227 226 227 
226 227 70 71 70 71 70 71 70 71 70 71 70 71 70 71 70 71 226 227 
226 227 1 1 1 1 1 1 1 1 1 1 1 1 1 1 1 1 226 227 
226 227 1 1 1 1 1 1 1 1 1 1 1 1 1 1 1 1 226 227 
226 227 1 1 1 1 1 1 1 1 1 1 1 1 82 83 1 1 226 227 
226 227 1 1 82 83 1 1 1 1 1 1 1 1 78 79 1 1 226 227 
70 70 1 1 78 79 1 1 1 1 82 83 1 1 1 1 1 1 226 227 
1 1 1 1 1 1 1 1 1 1 78 79 1 1 1 1 1 1 226 227 
1 1 1 1 1 1 1 1 1 1 1 1 1 1 1 1 1 1 226 227 
75 75 1 1 1 1 1 1 1 1 1 1 1 1 1 1 1 1 226 227 
226 227 1 1 1 1 1 1 1 1 1 1 1 1 1 1 1 1 226 227 
226 227 1 1 1 1 82 83 1 1 1 1 1 1 1 1 1 1 226 227 
226 227 1 1 1 1 78 79 1 1 1 1 1 1 82 83 1 1 226 227 
226 227 1 1 1 1 1 1 1 1 1 1 1 1 78 79 1 1 226 227 
226 227 1 82 83 1 1 1 1 1 82 83 1 1 1 1 1 1 226 227 
226 227 1 78 79 1 1 1 1 1 78 79 1 1 1 1 1 1 226 227 
226 227 1 1 1 1 1 1 1 1 1 1 1 1 1 1 1 1 226 227 
226 227 1 1 1 1 1 1 1 1 1 1 1 1 1 1 1 1 226 227 
226 227 74 75 74 75 74 75 74 75 74 75 74 75 74 75 74 75 226 227 
227 227 227 227 227 227 227 227 227 227 227 227 227 227 227 227 227 227 227 227 
1 1 1 1 1 1 1 1 1 1 1 1 1 1 1 1 1 1 1 1 
1 1 1 1 1 1 1 1 1 1 1 1 1 1 1 1 1 1 1 1 
1 1 0 0 0 0 0 0 0 0 0 0 0 0 0 0 0 0 1 1 
1 1 0 0 0 0 0 0 0 0 0 0 0 0 0 0 0 0 1 1 
1 1 0 0 0 0 0 0 0 0 0 0 0 0 1 1 0 0 1 1 
1 1 0 0 1 1 0 0 0 0 0 0 0 0 1 1 0 0 1 1 
0 0 0 0 1 1 0 0 0 0 1 1 0 0 0 0 0 0 1 1 
0 0 0 0 0 0 0 0 0 0 1 1 0 0 0 0 0 0 1 1 
0 0 0 0 0 0 0 0 0 0 0 0 0 0 0 0 0 0 1 1 
1 1 0 0 0 0 0 0 0 0 0 0 0 0 0 0 0 0 1 1 
1 1 0 0 0 0 0 0 0 0 0 0 0 0 0 0 0 0 1 1 
1 1 0 0 0 0 1 1 0 0 0 0 0 0 0 0 0 0 1 1 
1 1 0 0 0 0 1 1 0 0 0 0 0 0 1 1 0 0 1 1 
1 1 0 0 0 0 0 0 0 0 0 0 0 0 1 1 0 0 1 1 
1 1 0 1 1 0 0 0 0 0 1 1 0 0 0 0 0 0 1 1 
1 1 0 1 1 0 0 0 0 0 1 1 0 0 0 0 0 0 1 1 
1 1 0 0 0 0 0 0 0 0 0 0 0 0 0 0 0 0 1 1 
1 1 0 0 0 0 0 0 0 0 0 0 0 0 0 0 0 0 1 1 
1 1 1 1 1 1 1 1 1 1 1 1 1 1 1 1 1 1 1 1 
1 1 1 1 1 1 1 1 1 1 1 1 1 1 1 1 1 1 1 1 
/enemy 11 0 SATURN chaser 10
/enemy 19 -8 SATURN chaser 10
/enemy 12 -8 SATURN chaser 10
/enemy 10 10 SATURN chaser 10
sign 2 18 This is a forest
connect Bigger_Town left -32 0
