20
20
Test Grass Field
The Forest
1
70 71 70 71 70 1 1 71 70 70 71 70 71 70 70 71 70 70 70 71 
1 1 1 1 1 1 1 1 1 1 1 1 1 1 1 1 1 1 1 1 
1 1 1 1 1 1 1 1 1 1 1 1 1 1 1 1 1 1 1 1 
1 1 1 1 16 72 11 72 17 72 72 11 72 18 1 1 1 1 1 1 
1 1 1 1 12 68 7 68 13 68 68 7 68 14 1 1 1 1 1 1 
1 1 1 1 8 9 9 9 9 9 9 9 9 10 1 1 1 1 1 1 
1 1 1 1 4 5 5 5 5 5 5 5 5 6 1 1 1 1 1 1 
1 1 1 1 1 1 1 1 1 1 1 1 1 1 1 1 1 1 1 1 
1 1 1 1 1 1 1 1 1 1 1 1 1 1 1 1 1 1 1 1 
1 1 1 1 16 72 11 72 17 72 72 11 72 18 1 1 1 1 1 1 
1 1 1 1 12 68 7 68 13 68 68 7 68 14 1 1 1 1 1 1 
1 1 1 1 8 9 9 9 9 9 9 9 9 10 1 1 1 1 1 1 
1 1 1 1 4 5 5 5 5 5 5 5 5 6 1 1 1 1 1 1 
1 1 1 1 1 1 1 1 1 1 1 1 1 1 1 1 1 1 1 1 
1 1 1 1 1 1 1 1 1 1 1 1 1 1 1 1 1 1 1 1 
1 1 1 48 49 50 51 1 1 1 1 1 1 1 48 33 34 35 1 1 
1 1 1 44 45 46 47 1 1 1 1 1 1 1 28 29 30 31 1 1 
1 1 1 40 41 42 43 1 1 1 1 1 1 1 24 25 26 27 1 1 
1 1 1 36 37 38 39 1 1 1 1 1 1 1 20 21 21 23 1 1 
74 75 74 75 75 74 75 74 74 74 75 74 75 75 74 75 74 75 74 74 
1 1 1 1 1 0 0 1 1 1 1 1 1 1 1 1 1 1 1 1 
0 0 0 0 0 0 0 0 0 0 0 0 0 0 0 0 0 0 0 0 
0 0 0 0 0 0 0 0 0 0 0 0 0 0 0 0 0 0 0 0 
0 0 0 0 1 1 1 1 0 1 1 1 1 1 0 0 0 0 0 0 
0 0 0 0 1 1 1 1 1 1 1 1 1 1 0 0 0 0 0 0 
0 0 0 0 1 1 1 1 1 1 1 1 1 1 0 0 0 0 0 0 
0 0 0 0 0 0 0 0 0 0 0 0 0 0 0 0 0 0 0 0 
0 0 0 0 0 0 0 0 0 0 0 0 0 0 0 0 0 0 0 0 
0 0 0 0 0 0 0 0 0 0 0 0 0 0 0 0 0 0 0 0 
0 0 0 0 1 1 1 1 0 1 1 1 1 1 0 0 0 0 0 0 
0 0 0 0 1 1 1 1 1 1 1 1 1 1 0 0 0 0 0 0 
0 0 0 0 1 1 1 1 1 1 1 1 1 1 0 0 0 0 0 0 
0 0 0 0 0 0 0 0 0 0 0 0 0 0 0 0 0 0 0 0 
0 0 0 0 0 0 0 0 0 0 0 0 0 0 0 0 0 0 0 0 
0 0 0 0 0 0 0 0 0 0 0 0 0 0 0 0 0 0 0 0 
0 0 0 1 0 1 1 0 0 0 0 0 0 0 1 0 1 1 0 0 
0 0 0 1 1 1 1 0 0 0 0 0 0 0 1 1 1 1 0 0 
0 0 0 1 1 1 1 0 0 0 0 0 0 0 1 1 1 1 0 0 
0 0 0 0 0 0 0 0 0 0 0 0 0 0 0 0 0 0 0 0 
1 1 1 1 1 1 1 1 1 1 1 1 1 1 1 1 1 1 1 1 
/npc joe 9 14 NESS do_nothing do_nothing
/npc vinny 16 11 POKEMON walk_up_and_down stay_or_go
/npc bobobo-bobobo 2 10 NESS walk_up_and_down yoyoyo
/npc bobby 3 7 POKEMON walk_left_and_right yoyoyo
/npc vincent 16 6 POKEMON walk_up_and_down buy
npc ness 16 2 NESS jog_no_sleep cant_talk
warp Somewhere_Inside 8 9
connect NPC_Test_Map down -6 -20
