20
20
1  1  1  1  1  1  1  1  1  1  1  1  1  1  1  1  1  1  1  1 
1  1  1  1  1  1  1  1  1  1  1  1  1  1  1  1  1  1  1  1 
1  1  1  1 16 72 11 72 17 72 72 11 72 18  1  1  1  1  1  1 
1  1  1  1 12 68  7 68 13 68 68  7 68 14  1  1  1  1  1  1 
1  1  1  1  8  9  9  9  9  9  9  9  9 10  1  1  1  1  1  1 
1  1  1  1  4  5  5  5  5  5  5  5  5  6  1  1  1  1  1  1 
1  1  1  1  1  1  1  1  1  1  1  1  1  1  1  1  1  1  1  1 
1  1  1  1  1  1  1  1  1  1  1  1  1  1  1  1  1  1  1  1 
1  1  1  1  1  1  1  1  1  1  1  1  1  1  1  1  1  1  1  1 
1  1  1  1 16 72 11 72 17 72 72 11 72 18  1  1  1  1  1  1 
1  1  1  1 12 68  7 68 13 68 68  7 68 14  1  1  1  1  1  1 
1  1  1  1  8  9  9  9  9  9  9  9  9 10  1  1  1  1  1  1 
1  1  1  1  4  5  5  5  5  5  5  5  5  6  1  1  1  1  1  1 
1  1  1  1  1  1  1  1  1  1  1  1  1  1  1  1  1  1  1  1 
1  1  1  1  1  1  1  1  1  1  1  1  1  1  1  1  1  1  1  1 
1  1  1 48 49 50 51  1  1  1  1  1  1  1 48 33 34 35  1  1 
1  1  1 44 45 46 47  1  1  1  1  1  1  1 28 29 30 31  1  1 
1  1  1 40 41 42 43  1  1  1  1  1  1  1 24 25 26 27  1  1 
1  1  1 36 37 38 39  1  1  1  1  1  1  1 20 21 21 23  1  1 
1  1  1  1  1  1  1  1  1  1  1  1  1  1  1  1  1  1  1  1 
npc joe 2 1 NESS do_nothing do_nothing
npc vin 5 5 POKEMON walk_up_and_down stay_or_go
script surprise_attack 1 1 joe
warp Test_Map_2 8 2
