20
20
1 1 1 1 1 1 1 1 1 1 1 1 1 1 1 1 1 1 1 1 
1 1 1 1 1 1 1 1 1 1 1 1 1 1 1 1 1 1 1 1 
1 1 48 49 50 51 1 1 1 1 1 48 49 50 51 1 1 1 1 1 
1 1 44 45 46 47 1 1 1 1 1 44 45 46 47 1 1 1 1 1 
1 1 40 41 42 43 1 1 1 48 49 40 41 42 43 1 1 1 1 1 
1 1 36 37 38 39 1 1 1 44 45 36 37 38 39 1 1 1 1 1 
1 1 1 1 1 1 1 1 1 40 41 42 43 51 1 1 1 1 1 1 
1 1 1 1 1 1 1 1 1 36 37 38 39 47 1 1 1 1 1 1 
1 1 1 1 1 1 1 1 1 1 40 41 42 43 1 1 1 1 1 1 
1 1 1 48 49 50 51 1 1 1 36 37 38 39 1 1 1 1 1 1 
1 1 1 44 45 46 47 1 1 1 1 1 1 1 1 1 1 1 1 1 
1 1 1 40 41 42 43 1 1 1 1 1 48 49 50 51 1 1 1 1 
1 1 1 36 37 38 39 1 1 1 1 1 44 45 46 47 1 1 1 1 
1 1 1 1 1 1 1 1 1 1 1 1 40 41 42 43 1 1 1 1 
1 1 1 1 1 1 1 1 1 1 1 1 36 37 38 39 1 1 1 1 
1 48 49 50 51 1 1 1 1 1 1 1 1 1 1 1 1 1 1 1 
1 44 45 46 47 48 49 50 51 1 1 1 1 1 1 1 1 1 1 1 
1 40 41 42 43 44 45 46 47 1 1 1 1 1 1 1 1 1 1 1 
1 36 37 38 39 40 41 42 43 1 1 1 1 1 1 1 1 1 1 1 
1 1 1 1 1 36 37 38 39 1 1 1 1 1 1 1 1 1 1 1 
0 0 0 0 0 0 0 0 0 0 0 0 0 0 0 0 0 0 0 0 
0 0 0 0 0 0 1 0 0 0 1 0 0 0 0 0 0 0 0 0 
0 0 0 1 0 0 0 0 0 0 0 0 0 0 0 0 0 0 0 0 
0 0 0 0 0 0 0 0 0 0 0 0 0 0 0 0 0 0 0 0 
0 0 1 0 0 0 0 0 0 0 0 0 0 1 0 0 0 0 0 0 
0 0 0 1 0 0 0 0 0 0 0 0 0 0 0 0 1 0 0 0 
0 0 0 0 0 1 0 0 0 0 0 0 0 0 0 0 0 0 0 0 
0 0 0 0 0 0 0 0 0 1 0 0 0 0 0 0 0 1 0 0 
0 0 1 0 0 0 0 0 0 0 1 0 0 0 0 0 0 0 0 0 
0 0 0 0 0 0 0 0 0 0 0 0 0 0 0 1 0 0 0 0 
0 0 0 0 1 0 0 0 1 0 0 0 0 0 0 0 0 0 0 0 
0 0 0 0 0 0 0 0 0 0 0 0 1 0 0 1 0 0 0 0 
0 0 0 0 0 0 0 0 0 0 0 0 0 0 0 0 0 0 0 0 
0 0 0 1 0 0 0 1 0 0 0 0 0 0 0 0 1 0 0 0 
0 0 0 0 0 0 0 0 0 1 0 0 0 0 0 0 0 1 0 0 
0 0 0 0 0 0 0 0 0 0 0 0 0 1 0 0 0 0 0 0 
0 0 0 0 0 1 0 0 0 0 0 0 0 0 0 0 0 0 0 0 
0 0 0 0 0 0 0 0 0 0 0 0 0 0 0 1 0 0 0 0 
0 0 0 0 0 0 0 0 0 0 0 1 0 0 1 0 0 0 0 0 
0 0 0 0 0 0 0 0 0 0 0 0 0 0 0 0 0 0 0 0 
